NO  ./textures/lionwall.xpm
SO  ./textures/vinewall.xpm
EA  ./textures/patternwall.xpm
WE  ./textures/pillarwall.xpm

F  87,242,146
C  95,97,232

  111111111
  100000001
11100000001
1E000011001
10000011001
100000000011111111
100001010010000001
100000000010011001
100001010010000001
100000000010000001
100000000000000001
10000000000000000111
10000000001000000001
11111111111011111101
10000000000010001001
10111111111110101011
1000000000001010101
1111111111100010101
          111110101
              10001
              11111
