SO ./textures/lol.xpm
WE ./textures/west.xpm
EA ./textures/east.xpm
NO ./textures/north.xpm

C 51,53,51
F 36,85,1


111111111111111111111111111
111111111111111111111111111
111111111111111111111111111
11111111111111111111W000001
111111111111111111111111111
111111111111111111111111111
111111111111111111111111111
111111111111111111111111111
111111111111111111111111111
11
111 1  1          111
11 1 1   1111
101 1
11 1
111