NO textures/north.xpm
SO textures/south.xpm
F 1,1,1
WE textures/west.xpm
EA textures/east.xpm
C 98, 47, 34
 1111111111111111
 1111111111111111111111111111111111111111
100000111000000011111111111
 1010000010110E00001001
 1010000100110000001001
 1111111111101111111111
         111111


