NO ./textures/north.xpm
SO ./textures/south.xpm
F 128,128,128
C 98, 47, 34
WE ./textures/west.xpm
EA ./textures/east.xpm
1111111111111111111111
1010010000100001110001
1000111010001011100001
1010000010110E00001001
11111111110111111001111111111111
         111    100000000000000111111
                100000000000000000001
                100000000011110000001
                1000000000001100000011
                111111000000000000001
        11111111111110000001111111111
        10000000000000000001
        10000000111000000001
        10000000000001110001
        11111111111111111111
