SO ./textures/south.xpm
WE ./textures/west.xpm

EA ./textures/east.xpm
F 128,128,128
C 98,47,34
NO ./textures/north.xpm

    111111111111111   1111111111111111111
    100000000000001   1000000000000000001
    100000000000001   1000000000000000001
    100000000000001   1000000000000000001
    100000000000001   100000000S000000001
    100000000000001   1000000000000000001
    100000000000001   1000000000000000001   
    100000000000001   1000000000000000001
    100000000000001   1000000000010000001
    100000000000001   1000000000000000001
    100000000000001   1000000000000000001
    111111111111111   1111111111111111111
