

SO ./textures/south.xpm
WE ./textures/west.xpm
EA ./textures/east.xpm
NO ./textures/north.xpm


C 51 , 53 , 51
F 36 , 85 , 5

1111111111111111111111111
1010000001000000100000001
1010111100011110001110N01
10100S0001000000100000001
1111111111111111111111111