NO textures/north.xpm

EA textures/east.xpm

WE textures/west.xpm

SO textures/south.xpm

F 122,144,0

C 133,44,11

11111111111
10000000001111
100000000000011
1111100000000001
1111000000000011
1100000000000001
100000000000000111111
1000000000000000000001
10000000000000000000W1
1111111111111111111111
